111111111111111111111111
100000000000000000000001
100000000000000000010001
100000010000000000011111
100000010000000000000001
100000010000000000000001
100000010000000000000001
111111110000000111111111
100000000000000100000001
100000000000000100000001
100000000000000000000001
100000000000000000000001
100000100000000100000001
100000100000000111111111
100000100000000000000001
100000100000000000000001
100000100000000000000001
100000100000000000000001
100000111111000000000001
100000100000000000000001
100000100000000000000001
100000100000000000000001
100000100000000000000001
111111111111111111111111
