111111111111111111111111
100000000000000000000001
100000000000000000000001
100000000000000000000001
111111111000000000000001
100000001000000000000001
100000001000000000000001
100000001000000000000001
100000001000000000000001
100000001000000000000001
100000001000000000000001
100000001000000000000001
100000001000000000000001
100000001000000000000001
100000001000000000000001
100000001000000000000001
100011111000000111111111
100000000000000100000001
100000000000000100000001
100000000000000100000001
100000000000000000000001
100000000000000000000001
100000000000000000000001
111111111111111111111111
