1111111111
1000010001
1000010001
1000011001
1000000001
1010200001
1010000001
1110000001
1000000001
1111111111
