1111111111
1000010001
10000100011
1000011001
10000000011
10102000011
1010000001
1110000001
1000000001
1111111111
