1111111111111
1000000001001
1000000001001
1000000001001
1000000000001
1000000000001
1000000000001
1000000001001
1110000001001
1010000001111
1010000001001
1000000000001
1111111111111
