R 1920 1080
NO ./path_no
SO ./path_so
WE ./path_we
EA ./path_ea
S ./path_s
F 220, 100, 0
C 255,  30, 0
11111111111111111111
10000000000000000001
10000000000000011111
10000000000000010001
11111111100000010001
10000000100000010001
10000000100000010001
10000000100000000001
10000000100000000001
10000000100000000001
10000000000000000001
10000000000000000001
10000000000000000001
10000000000000000001
10000000111110000001
10000000100000000001
10000000100000000001
10000000100000000001
10000000100000000001
11111111111111111111
