11111111111111111111
10000000000000000001
10000000000000000001
10000000000000000001
10000000000000000001
11111100000000000001
10000100000000000001
10000100000000000001
10000100000000000001
10000100000000000001
10000100000000000001
10000100000000000001
10000000000000000001
10000000000000000001
10000100000001111111
10000100000001000001
10000100000001000001
10000100000001000001
10000100000001000001
11111111111111111111
