1111111111
1000010001
10000110011
10000000011
1010200001
1010001111
1110001
1000001111
1111111111
